10.ox
..........
..........
..........
o......o.o
..........
.........o
.oo..oo...
.oo.......
.........o
..........
